"Oh, you've arrived," says Solomon.

The Queen of Sheba
An Interactive Fiction
Release 1 / Serial number 121023 / Inform 7 build 6G60 (I6/v6.32 lib 6/12N) SD

Hall of Almug Tree Pillars
The pillars of the room are made of almug tree, the ceiling made of silk and the floor of glass.

You can see Solomon here.

>read chart
You read: Mildred Christian, age _____, chief complaint, pulse ______

>in
Exam room
This is a standard clinic exam room.  There is an exam table and two chairs. Standard medical examination equipment is available here.

Ms. Christian lies on the exam table shivering. She has a heavy down coat drawn up around her face. She seems uncomfortable, but is able to answer questions.

You can also see a boyfriend here.

>mildred, hello
"Hello, Doctor."

>mildred, tell me your chief complaint
"I've just been so sick, mainly sick to my stomach.

>mildred, how long have you been sick
"Hmmf," says Mildred Christian.

* * *

"Oh, you've arrived," says Solomon.

The Queen of Sheba
An Interactive Fiction
Release 1 / Serial number 121023 / Inform 7 build 6G60 (I6/v6.32 lib 6/12N) SD

Hall of Almug Tree Pillars
The pillars of the room are made of almug tree, the ceiling made of silk and the floor of glass.

You can see Solomon here.

>in
Exam room
This is a standard clinic exam room.  There is an exam table and two chairs. Standard medical examination equipment is available here.

Ms. Christian lies on the exam table shivering. She has a heavy down coat drawn up around her face. She seems uncomfortable, but is able to answer questions.

You can also see a boyfriend here.

>ask boyfriend
You can only do that to something animate.

* * *

>in
Exam room
This is a standard clinic exam room.  There is an exam table and two chairs. Standard medical examination equipment is available here.

Ms. Christian lies on the exam table shivering. She has a heavy down coat drawn up around her face. She seems uncomfortable, but is able to answer questions.

You can also see a boyfriend here.

>ask mildred about complaint
"Hmmf," says Mildred Christian.

>ask mildred about age
"I am 22 years old."

>ask mildred about chief complaint
"I've just been so sick, mainly sick to my stomach.

* * *

>in
Exam room
This is a standard clinic exam room.  There is an exam table and two chairs. Standard medical examination equipment is available here.

Ms. Christian lies on the exam table shivering. She has a heavy down coat drawn up around her face. She seems uncomfortable, but is able to answer questions.

You can also see a boyfriend here.

>hi, boyfriend
(addressing Mildred Christian)
"Hello, Doctor."

That's not a verb I recognise.

>say hi toher
Whom do you want to say that to?

>say hi to her
You are already talking to Mildred Christian.

>mildred, hello
You are already talking to Mildred Christian.

>out
Clinic hallway
It's your usual Wednesday at the West Berkeley Health Center. The nurse tells you about the next patient to see. "Her name is Mildred Christian. Her boyfriend brought her here. He says she has the flu."

You can see a chart here.

>in
Exam room
This is a standard clinic exam room.  There is an exam table and two chairs. Standard examination equipment is available

Ms. Christian lies on the exam table shivering. She has a heavy down coat drawn up around her face. She seems uncomfortable, but is able to answer questions.

You can also see a boyfriend here.

>mildred, hello
"Hello, Doctor."

>boyfriend, hello
"Hey doc, I'm just the boyfriend."

>t sarah hello
This provokes no reaction.

>t sarah hi
This provokes no reaction.

* * *

>in
Exam room
This is a standard clinic exam room.  There is an exam table and two chairs. Standard medical examination equipment is available here.

Ms. Christian lies on the exam table shivering. She has a heavy down coat drawn up around her face. She seems uncomfortable, but is able to answer questions.

You can also see a boyfriend here.

>ask mildred about age
"Hmmf," says Mildred Christian.

* * *

>ask mildred age
I didn't understand that sentence.

>age
That's not a verb I recognise.

>hello, mildred
You are already talking to Mildred Christian.

That's not a verb I recognise.

>mildred, hi
You are already talking to Mildred Christian.

>ask mildred about her age
"Hmmf," says Mildred Christian.

>mildred, what is your age
"Hmmf," says Mildred Christian.

>mildred
That's not a verb I recognise.

>mildred, give me your age
"Hmmf," says Mildred Christian.

* * *

>in
Exam room
This is a standard clinic exam room.  There is an exam table and two chairs. Standard medical examination equipment is available here.

Ms. Christian lies on the exam table shivering. She has a heavy down coat drawn up around her face. She seems uncomfortable, but is able to answer questions.

You can also see a boyfriend here.

>mildred, what is your age
"I am 22 years old."

>mildred, tell me your age
"I am 22 years old."

>boyfriend, tell me your age
The boyfriend has better things to do.

* * *

>ask mildred
What do you want to ask Mildred Christian for?

>ask mildred about age
(Mildred Christian about that)
"I am 22 years old."

>mildred age
That's not a verb I recognise.

>age
That's not a verb I recognise.

* * *

>ask mildred what is your age
I didn't understand that sentence.

>ask mildred her age
I didn't understand that sentence.

>ask mildred age
I didn't understand that sentence.

* * *

>in
Exam room
This is a standard clinic exam room.  There is an exam table and two chairs. Standard medical examination equipment is available here.

Ms. Christian lies on the exam table shivering. She has a heavy down coat drawn up around her face. She seems uncomfortable, but is able to answer questions.

You can also see a boyfriend here.

>hi mildred
I only understood you as far as wanting to hi.

>hi, mildred
(addressing Mildred Christian)
"Hello, Doctor."

That's not a verb I recognise.

>talk to mildred
Which do you mean, Mildred Christian or Mildred Christian's boyfriend?

>talk to mildred christian
Which do you mean, Mildred Christian or Mildred Christian's boyfriend?

* * *

>in
Exam room
This is a standard clinic exam room.  There is an exam table and two chairs. Standard medical examination equipment is available here.

Ms. Christian lies on the exam table shivering. She has a heavy down coat drawn up around her face. She seems uncomfortable, but is able to answer questions.

You can also see a boyfriend here.

>mildred, what in the heck xxx are you
"Hmmf," says Mildred Christian.

* * *

>in
Exam room
This is a standard clinic exam room.  There is an exam table and two chairs. Standard medical examination equipment is available here.

Ms. Christian lies on the exam table shivering. She has a heavy down coat drawn up around her face. She seems uncomfortable, but is able to answer questions.

You can also see a boyfriend here.

>mildred,  hi
"Hello, Doctor."

>mildred, what is your age
"22"

>mildred, can you give me your age
"22"

>what is your age
That's not a verb I recognise.

* * *

>in
Exam room
This is a standard clinic exam room.  There is an exam table and two chairs. Standard medical examination equipment is available here.

Ms. Christian lies on the exam table shivering. She has a heavy down coat drawn up around her face. She seems uncomfortable, but is able to answer questions.

You can also see a boyfriend here.

>hello, mildred
(addressing Mildred Christian)
"Hello, Doctor."

That's not a verb I recognise.

>hello, boyfriend
You are already talking to Mildred Christian.

That's not a verb I recognise.

>tell mildred hello
(Mildred Christian that)
"Hi Doctor."

* * *

>hello, mildred
(addressing Mildred Christian)
"Hello, Doctor."

That's not a verb I recognise.

>hello
You are already talking to Mildred Christian.

>mildred hello
That's not a verb I recognise.

>hello mildred
I only understood you as far as wanting to hello.

>hello, mildred
You are already talking to Mildred Christian.

That's not a verb I recognise.

>mildred
That's not a verb I recognise.

>look at mildred
Which do you mean, Mildred Christian or Mildred Christian's boyfriend?

>look at boyfriend
You see nothing special about Mildred Christian's boyfriend.

>look
Exam room
This is a standard clinic exam room.  There is an exam table and two chairs. Standard examination equipment is available

Ms. Christian lies on the exam table shivering. She has a heavy down coat drawn up around her face. She seems uncomfortable, but is able to answer questions.

You can also see Mildred Christian's boyfriend here.

>hello, mildred
You are already talking to Mildred Christian.

That's not a verb I recognise.

>talk to mildred
Which do you mean, Mildred Christian or Mildred Christian's boyfriend?

>talk to boyfriend
Mildred Christian's boyfriend does not respond.

* * *

>in
Exam room
This is a standard clinic exam room.  There is an exam table and two chairs. Standard medical examination equipment is available here.

Ms. Christian lies on the exam table shivering. She has a heavy down coat drawn up around her face. She seems uncomfortable, but is able to answer questions.

You can also see a boyfriend here.

>mildred, how old are you
"I am 22 years old."

>mildred, what is your chief complaint
"I've just been so sick, mainly sick to my stomach.

* * *

>in
Exam room
This is a standard clinic exam room.  There is an exam table and two chairs. Standard medical examination equipment is available here.

Ms. Christian lies on the exam table shivering. She has a heavy down coat drawn up around her face. She seems uncomfortable, but is able to answer questions.

You can also see a boyfriend here.

>hello boyfriend
I only understood you as far as wanting to hello.

>hello, boyfriend
(addressing Mildred Christian)
"Hello, Doctor."

That's not a verb I recognise.

>talk to boyfriend
Mildred Christian's boyfriend does not respond.

>say hello to boyfriend
Mildred Christian's boyfriend does not respond.

* * *

"Oh, you've arrived," says Solomon.

The Queen of Sheba
An Interactive Fiction
Release 1 / Serial number 121023 / Inform 7 build 6G60 (I6/v6.32 lib 6/12N) SD

Hall of Almug Tree Pillars
The pillars of the room are made of almug tree, the ceiling made of silk and the floor of glass.

You can see Solomon here.

>look Mildred
You can't see any such thing.

>in
Exam room
This is a standard clinic exam room.  There is an exam table and two chairs. Standard examination equipment is available

Ms. Christian lies on the exam table shivering. She has a heavy down coat drawn up around her face. She seems uncomfortable, but is able to answer questions.

You can also see Mildred Christian's boyfriend here.

>look her
You see nothing special about Mildred Christian.

>look at her
You see nothing special about Mildred Christian.

* * *

"Oh, you've arrived," says Solomon.

The Queen of Sheba
An Interactive Fiction
Release 1 / Serial number 121023 / Inform 7 build 6G60 (I6/v6.32 lib 6/12N) SD

Hall of Almug Tree Pillars
The pillars of the room are made of almug tree, the ceiling made of silk and the floor of glass.

You can see Solomon here.

>what is rain
That's not a verb I recognise.

>solomon, what is rain
"Clouds are a disturbance made by the paths of birds," Solomon replies. "The air beaten by their wings becomes agitated, as when a river is stirred and the mud churns up."

>solomon where is rain
That's not a verb I recognise.

>wolomon, where is the rain
You seem to want to talk to someone, but I can't see whom.

>solomon, where is the rain
"Weather is contained in a great silk bag which holds in the heavens," replies Solomon.