Mildred Christian
An Interactive Fiction by Judith A. Lubbers, M.D;  Inform version by Keith Flower.
Release 1 / Serial number 121028 / Inform 7 build 6G60 (I6/v6.32 lib 6/12N) SD

Clinic hallway
It's your usual Wednesday at the West Berkeley Health Center. You are standing in the hallway outside an exam room.

You can see a chart here.

9:00 am

>in
Exam room
This is a standard clinic exam room.  There is an exam table and two chairs. Standard medical examination equipment is available here.

Ms. Christian lies on the exam table shivering. She has a heavy down coat drawn up around her face. She seems uncomfortable, but is able to answer questions.

9:01 am

>mildred, age
I am 22 years old."

[Your score has just gone up by one point.]

9:02 am

>mildred, why is she here
"Hmmf," says Mildred Christian.

9:03 am

>mildred, why she is here
I've just been so sick, mainly sick to my stomach.

[Your score has just gone up by one point.]

9:04 am

>mildred details
That's not a verb I recognise.

9:04 am

>mildred, details
I've been throwing up all day. Whatever I eat goes right through me, and now I don't want to eat. My stomach hurts. 

Great, you got the initial information
[Your score has just gone up by one point.]

9:05 am

>mildred, times vomited
"Hmmf," says Mildred Christian.

9:06 am

>mildred, diarrhea
I haven't thrown up anything like coffee grounds, nor bright red blood.

[Your score has just gone up by one point.]

9:07 am

>mildred, black
"Hmmf," says Mildred Christian.

9:08 am

>mildred, black stools
"Hmmf," says Mildred Christian.

9:09 am

>mildred, tarry
"Hmmf," says Mildred Christian.

9:10 am

>mildred, vomit
"Hmmf," says Mildred Christian.

9:11 am

>mildred, times vomited
"Hmmf," says Mildred Christian.

9:12 am

>mildred diarrhea
That's not a verb I recognise.

9:12 am

>mildred, diarrhea
I haven't thrown up anything like coffee grounds, nor bright red blood.

9:13 am

>mildred, diarrhea appearance
I haven't thrown up anything like coffee grounds, nor bright red blood.

9:14 am

* * *

>mildred, age
I am 22 years old."

[Your score has just gone up by one point.]

9:02 am

>mildred, details
I've been throwing up all day. Whatever I eat goes right through me, and now I don't want to eat. My stomach hurts. 

Great, you got the initial information. Let's get some additional detail about the HPI
You enter the exam room.

[Your score has just gone up by one point.]

9:03 am

>mildred, pain
It's been crampy, and it comes and goes.

[Your score has just gone up by one point.]

9:04 am

>mildred, diarrhea
I haven't thrown up anything like coffee grounds, nor bright red blood.

[Your score has just gone up by one point.]

9:05 am

>mildred, vomit
I started throwing up about 8 hours ago.

Ok, enough info - let's do an exam on the patient.

[Your score has just gone up by one point.]

9:06 am

>listen to mildred's heart
9:07 am

>auscultate mildred's heart
9:08 am

* * *

>mildred, details
I've been throwing up all day. Whatever I eat goes right through me, and now I don't want to eat. My stomach hurts. 

Great, you got the initial information. Let's get some additional detail about the HPI
You enter the exam room.

[Your score has just gone up by one point.]

9:03 am

>mildred, vomit
I started throwing up about 8 hours ago.

[Your score has just gone up by one point.]

9:04 am

>mildred, diarrhea
I haven't thrown up anything like coffee grounds, nor bright red blood.

[Your score has just gone up by one point.]

9:05 am

>mildred, pain
It's been crampy, and it comes and goes.

Ok, enough info - let's do an exam on the patient.

[Your score has just gone up by one point.]

9:06 am

>listen to mildred's heart
9:07 am

* * *

>mildred, age
I am 22 years old."

[Your score has just gone up by one point.]

9:02 am

>pt, details
I've been throwing up all day. Whatever I eat goes right through me, and now I don't want to eat. My stomach hurts. 

Great, you got the initial information. Let's get some additional detail about the HPI
You enter the exam room.

[Your score has just gone up by one point.]

9:03 am

>ask pt for complaint
9:04 am

>ask pt for her complaint
9:05 am

>ask pt age
I didn't understand that sentence.

9:05 am

>mildred, complaint
"Hmmf," says Mildred Christian.

9:06 am

>ask mildred about vomiting
(Mildred Christian about that)
There is no reply.

9:07 am

>ask mildred about vomit
(Mildred Christian about that)
There is no reply.

9:08 am

>mildred, vomit
I started throwing up about 8 hours ago.

[Your score has just gone up by one point.]

9:09 am

>mildred, pain
It's been crampy, and it comes and goes.

[Your score has just gone up by one point.]

9:10 am

>mildred, tell me about diarrhea
There is no reply.

9:11 am

>mildred, tell me about pain
There is no reply.

9:12 am

>mildred, what about pain
It's been crampy, and it comes and goes.

9:13 am

>mildred, what about diarrhea
I haven't thrown up anything like coffee grounds, nor bright red blood.

Ok, enough info - let's do an exam on the patient.

[Your score has just gone up by one point.]

9:14 am

>listen to mildred's heart
You put your stethoscope at the apex and hear…
9:15 am

* * *

>mildred, age
I am 22 years old."

[Your score has just gone up by one point.]

9:02 am

>ask mildred for age
(Mildred Christian for)
I'm 22.

Great, you got the initial information. Let's get some additional detail about the HPI
You enter the exam room.

[Your score has just gone up by one point.]

9:03 am

>ask mildred for details
(Mildred Christian for)
9:04 am

>ask mildred for pain
(Mildred Christian for)
9:05 am

>ask mildred about pain
(Mildred Christian about that)
There is no reply.

9:06 am

* * *

>in
Exam room
This is a standard clinic exam room.  There is an exam table and two chairs. Standard medical examination equipment is available here.

Ms. Christian lies on the exam table shivering. She has a heavy down coat drawn up around her face. She seems uncomfortable, but is able to answer questions.

9:01 am

>mildred sit up
Mildred Christian sits up.

9:02 am

>take mildred pulse
142
9:03 am

>mildred stand up
Mildred Christian stands up.

9:04 am

>take mildred pulse
144
9:05 am

>mildred lay down
Mildred Christian lays down.

9:06 am

>take mildred pulse
130
9:07 am

* * *

>in
Exam room
This is a standard clinic exam room.  There is an exam table and two chairs. Standard medical examination equipment is available here.

Ms. Christian lies on the exam table shivering. She has a heavy down coat drawn up around her face. She seems uncomfortable, but is able to answer questions.

9:01 am

>mildred, sit up
"Hmmf," says Mildred Christian.

There is no reply.

9:02 am

* * *

>in
Exam room
This is a standard clinic exam room.  There is an exam table and two chairs. Standard medical examination equipment is available here.

Ms. Christian lies on the exam table shivering. She has a heavy down coat drawn up around her face. She seems uncomfortable, but is able to answer questions.

9:01 am

>ask mildred for her age
(Mildred Christian for)
9:02 am

>ask mildred for age
(Mildred Christian for)
I'm 22.

[Your score has just gone up by one point.]

9:03 am

>ask mildred about her age
(Mildred Christian about that)
I am 22 years old."

Great, you got the initial information. Let's get some additional detail about the HPI
You enter the exam room.

[Your score has just gone up by one point.]

9:04 am

>ask mildred about her pain
(Mildred Christian about that)
It's been crampy, and it comes and goes.

[Your score has just gone up by one point.]

9:05 am

>mildred, age
"Hmmf," says Mildred Christian.

9:06 am

>out
Clinic hallway
It's your usual Wednesday at the West Berkeley Health Center. You are standing in the hallway outside an exam room.

You can see a chart here.

9:07 am

>in
Exam room
This is a standard clinic exam room.  There is an exam table and two chairs. Standard medical examination equipment is available here.

Ms. Christian lies on the exam table shivering. She has a heavy down coat drawn up around her face. She seems uncomfortable, but is able to answer questions.

9:08 am

>mildred, details
"Hmmf," says Mildred Christian.

9:09 am

* * *

>in
Exam room
This is a standard clinic exam room.  There is an exam table and two chairs. Standard medical examination equipment is available here.

Ms. Christian lies on the exam table shivering. She has a heavy down coat drawn up around her face. She seems uncomfortable, but is able to answer questions.

9:01 am

>mildred what is your age
I didn't understand that sentence.

9:01 am

>mildred, what is your age
I am 22 years old."

[Your score has just gone up by one point.]

9:02 am

>ask mildred for her age
(Mildred Christian for)
9:03 am

>ask mildred her age
I didn't understand that sentence.

9:03 am

>ask mildred for her age
(Mildred Christian for)
9:04 am

>ask mildred for age
(Mildred Christian for)
I'm 22.

9:05 am

* * *

>in
Exam room
This is a standard clinic exam room.  There is an exam table and two chairs. Standard medical examination equipment is available here.

Ms. Christian lies on the exam table shivering. She has a heavy down coat drawn up around her face. She seems uncomfortable, but is able to answer questions.

9:01 am

>ask mildred for age
(Mildred Christian for)
I'm 22.

[Your score has just gone up by one point.]

9:02 am

>mildred, age
I am 22 years old."

Great, you got the initial information. Let's get some additional detail about the HPI
You enter the exam room.

[Your score has just gone up by one point.]

9:03 am

* * *

>ask mildred for age
(Mildred Christian for)
I'm 22.

[Your score has just gone up by one point.]

9:02 am

>ask mildred for her age
I only understood you as far as wanting to ask Mildred Christian for Mildred Christian.

9:01 am

>mildred, age
I am 22 years old."

[Your score has just gone up by one point.]

9:02 am

* * *

>in
Exam room
This is a standard clinic exam room.  There is an exam table and two chairs. Standard medical examination equipment is available here.

Ms. Christian lies on the exam table shivering. She has a heavy down coat drawn up around her face. She seems uncomfortable, but is able to answer questions.

9:01 am

>ask mildred to give her age
I didn't understand that sentence.

9:01 am

>ask mildred her age
I didn't understand that sentence.

9:01 am

>ask mildred about her age
(Mildred Christian about that)
I am 22 years old."

[Your score has just gone up by one point.]

9:02 am

>ask mildred for her age
(Mildred Christian for)
9:03 am

>mildred, tell me your age
I am 22 years old."

9:04 am

* * *

>in
Exam room
This is a standard clinic exam room.  There is an exam table and two chairs. Standard medical examination equipment is available here.

Ms. Christian lies on the exam table shivering. She has a heavy down coat drawn up around her face. She seems uncomfortable, but is able to answer questions.

9:01 am

>mildred, age?
I am 22 years old."

[Your score has just gone up by one point.]

9:02 am

>mildred, how old are you?
I am 22 years old."

9:03 am

>mildred, sit up
"Hmmf," says Mildred Christian.

9:04 am

>mildred sit up
Mildred Christian sits up.

9:05 am

* * *

>mildred, age?
I am 22 years old."

[Your score has just gone up by one point.]

9:02 am

>age?
That's not a verb I recognise.

9:02 am

>age
That's not a verb I recognise.

9:02 am

>mildred, age?
"Hmmf," says Mildred Christian.

9:03 am

>ask mildred, age?
You can't use multiple objects with that verb.

9:03 am

>ask mildred
What do you want to ask Mildred Christian for?

9:03 am

>ask mildred age?
I didn't understand that sentence.

9:03 am

* * *

>in
Exam room
This is a standard clinic exam room.  There is an exam table and two chairs. Standard medical examination equipment is available here.

Ms. Christian lies on the exam table shivering. She has a heavy down coat drawn up around her face. She seems uncomfortable, but is able to answer questions.

9:01 am

>mildred, what is your chief complaint
I've just been so sick, mainly sick to my stomach.

[Your score has just gone up by one point.]

9:02 am

>mildred, why are you here?
I've just been so sick, mainly sick to my stomach.

9:03 am

* * *

Mildred Christian
An Interactive Fiction by Judith A. Lubbers, M.D;  Inform version by Keith Flower.
Release 1 / Serial number 121028 / Inform 7 build 6G60 (I6/v6.32 lib 6/12N) SD

Clinic hallway
It's your usual Wednesday at the West Berkeley Health Center. You are standing in the hallway outside an exam room.

You can see a chart here.

9:00 am

>read chart
You read: 
  Mildred Christian
  Age _____ 
  Pulse ______ 
  Blood pressure _______ 
  Temp________ 
  Nurses notes:  "Her boyfriend brought her here. He says she has the flu"

9:01 am

>in
Exam room
This is a standard clinic exam room.  There is an exam table and two chairs. Standard medical examination equipment is available here.

Ms. Christian lies on the exam table shivering. She has a heavy down coat drawn up around her face. She seems uncomfortable, but is able to answer questions.

9:02 am

>mildred, age
I am 22 years old."

[Your score has just gone up by one point.]

9:03 am

>mildred how old are you
I didn't understand that sentence.

9:03 am

>get mildred age
I didn't understand that sentence.

9:03 am

>mildred, how old are you
I am 22 years old."

9:04 am

>pt, details
I've been throwing up all day. Whatever I eat goes right through me, and now I don't want to eat. My stomach hurts. 

[Your score has just gone up by one point.]

9:05 am

>pt, complaint
I've just been so sick, mainly sick to my stomach.

Great, you got some initial information. Now get into greater detail
You enter the exam room.

[Your score has just gone up by one point.]

9:06 am

>pt, pain
It's been crampy, and it comes and goes.

[Your score has just gone up by one point.]

9:07 am

>pt, diarrhea
I haven't thrown up anything like coffee grounds, nor bright red blood.

Ok, enough info - let's do an exam on the patient.

[Your score has just gone up by one point.]

9:08 am

>examine pt eyes
I only understood you as far as wanting to examine Mildred Christian.

9:08 am

>examine pt's eyes
I only understood you as far as wanting to examine Mildred Christian.

9:08 am

>examine mildred's eyes
9:09 am

>examine pt eyes
I only understood you as far as wanting to examine Mildred Christian.

9:09 am

* * *

Mildred Christian
An Interactive Fiction by Judith A. Lubbers, M.D;  Inform version by Keith Flower.
Release 1 / Serial number 121028 / Inform 7 build 6G60 (I6/v6.32 lib 6/12N) SD

Clinic hallway
It's your usual Wednesday at the West Berkeley Health Center. You are standing in the hallway outside an exam room.

You can see a chart here.

9:00 am

>enter exam room
Exam room
This is a standard clinic exam room.  There is an exam table and two chairs. Standard medical examination equipment is available here.

Ms. Christian lies on the exam table shivering. She has a heavy down coat drawn up around her face. She seems uncomfortable, but is able to answer questions.

9:01 am

>leave
Clinic hallway
It's your usual Wednesday at the West Berkeley Health Center. You are standing in the hallway outside an exam room.

You can see a chart here.

9:02 am

>enter exam room
Exam room
This is a standard clinic exam room.  There is an exam table and two chairs. Standard medical examination equipment is available here.

Ms. Christian lies on the exam table shivering. She has a heavy down coat drawn up around her face. She seems uncomfortable, but is able to answer questions.

9:03 am

>leave
Clinic hallway
It's your usual Wednesday at the West Berkeley Health Center. You are standing in the hallway outside an exam room.

You can see a chart here.

9:04 am

>take chart
You can't see any such thing.

9:04 am

>read chart
You read: 
  Mildred Christian
  Age _____ 
  Pulse ______ 
  Blood pressure _______ 
  Temp________ 
  Nurses notes:  "Her boyfriend brought her here. He says she has the flu"

9:05 am

>in
Exam room
This is a standard clinic exam room.  There is an exam table and two chairs. Standard medical examination equipment is available here.

Ms. Christian lies on the exam table shivering. She has a heavy down coat drawn up around her face. She seems uncomfortable, but is able to answer questions.

9:06 am

>mildred, why are you here
I've just been so sick, mainly sick to my stomach.

[Your score has just gone up by one point.]

9:07 am

>inventory
You are carrying:
  a tongue-depressor
  a stethoscope
  a penlight

9:08 am

>out
Clinic hallway
It's your usual Wednesday at the West Berkeley Health Center. You are standing in the hallway outside an exam room.

You can see a chart here.

9:09 am

>in
Exam room
This is a standard clinic exam room.  There is an exam table and two chairs. Standard medical examination equipment is available here.

Ms. Christian lies on the exam table shivering. She has a heavy down coat drawn up around her face. She seems uncomfortable, but is able to answer questions.

9:10 am

>out
Clinic hallway
It's your usual Wednesday at the West Berkeley Health Center. You are standing in the hallway outside an exam room.

You can see a chart here.

9:11 am

>knock
That's not a verb I recognise.

9:11 am

>enter
Exam room
This is a standard clinic exam room.  There is an exam table and two chairs. Standard medical examination equipment is available here.

Ms. Christian lies on the exam table shivering. She has a heavy down coat drawn up around her face. She seems uncomfortable, but is able to answer questions.

9:12 am

>mildred sit up
Mildred Christian sits up.

9:13 am

>mildred, age?
"Hmmf," says Mildred Christian.

9:14 am

>mildred, age
I am 22 years old."

[Your score has just gone up by one point.]

9:15 am

* * *

Mildred Christian
An Interactive Fiction by Judith A. Lubbers, M.D;  Inform version by Keith Flower.
Release 1 / Serial number 121028 / Inform 7 build 6G60 (I6/v6.32 lib 6/12N) SD

Clinic hallway
It's your usual Wednesday at the West Berkeley Health Center. You are standing in the hallway outside an exam room.

You can see a chart here.

9:00 am

>ask mildred about age
You can't see any such thing.

9:00 am

>in
Exam room
This is a standard clinic exam room.  There is an exam table and two chairs. Standard medical examination equipment is available here.

Ms. Christian lies on the exam table shivering. She has a heavy down coat drawn up around her face. She seems uncomfortable, but is able to answer questions.

9:01 am

>ask mildred about age
(Mildred Christian about that)
I am 22 years old."

[Your score has just gone up by one point.]

9:02 am

>ask mildred for her age
(Mildred Christian for)
9:03 am

>ask mildred about her age
(Mildred Christian about that)
I am 22 years old."

9:04 am

>ask mildred for age
(Mildred Christian for)
9:05 am