The Ring, the Gardener and the the Maid
An Interactive Fiction
Release 1 / Serial number 121023 / Inform 7 build 6G60 (I6/v6.32 lib 6/12N) SD

Dining Room
Most of the room is taken up with a large wooden dining table. The only way out is to the south.

On the large wooden dining table is a gold ring.

Sarah is busily polishing the table.

>get ring
Taken.

>south
Hall
This large bare hall has exits to north and east.

>north
Dining Room
Most of the room is taken up with a large wooden dining table. The only way out is to the south.

Sarah is busily polishing the table.

>tell sarah hello
"Excuse me", you say.

"Yes?" she asks.

She mutters something incomprehensible under her breath.

>tell woman hi
She mutters something incomprehensible under her breath.

>say hi to sarah
You are already talking to Sarah.

>chat with sarah
That's not a verb I recognise.

>hello sarah
I only understood you as far as wanting to hello.

>hello
You are already talking to Sarah.

>sarah
That's not a verb I recognise.

>say hello
You are already talking to Sarah.

>tell sarah hi
She mutters something incomprehensible under her breath.

>tell sarah hello
She mutters something incomprehensible under her breath.

>ask sarah about ring
"You don't mind if I take this ring then?" you ask.

"As long as you're only taking it to return it to its owner." she replies.

>ask sarah table
I didn't understand that sentence.

>ask sarah about table
"Have you been polishing that table long?" you ask.

"Long enough." she replies.

>say goodbye to sarah
Cheerio then," you say.

"See you," she replies.

>ask sarah about weather
"Excuse me", you say.

"Yes?" she asks.

"Lovely weather today, don't you think?" you remark.

"Don't you have anything more interesting to talk about?" she complains.

>ask sarah for weather
She mutters something incomprehensible under her breath.

>hi sarah
I only understood you as far as wanting to hi.

>hi, sarah
You are already talking to Sarah.

That's not a verb I recognise.

>hello, sarah
You are already talking to Sarah.

That's not a verb I recognise.