Mildred Christian
An Interactive Fiction
Release 1 / Serial number 121024 / Inform 7 build 6G60 (I6/v6.32 lib 6/12N) SD

Clinic hallway
It's your usual Wednesday at the West Berkeley Health Center. The nurse tells you about the next patient to see. "Her name is Mildred Christian. Her boyfriend brought her here. He says she has the flu."

You can see a chart here.

9:00 am

>read chart
You read: Mildred Christian, age _____, chief complaint, pulse ______

>in
Exam room
This is a standard clinic exam room.  There is an exam table and two chairs. Standard medical examination equipment is available here.

Ms. Christian lies on the exam table shivering. She has a heavy down coat drawn up around her face. She seems uncomfortable, but is able to answer questions.

You can also see a boyfriend here.

>mildred, hello
"Hello, Doctor."

>mildred, tell me your chief complaint
"I've just been so sick, mainly sick to my stomach.

>mildred, how long have you been sick
"Hmmf," says Mildred Christian.

* * *

Mildred Christian
An Interactive Fiction
Release 1 / Serial number 121024 / Inform 7 build 6G60 (I6/v6.32 lib 6/12N) SD

Clinic hallway
It's your usual Wednesday at the West Berkeley Health Center. The nurse tells you about the next patient to see. "Her name is Mildred Christian. Her boyfriend brought her here. He says she has the flu."

You can see a chart here.

9:00 am

>in
Exam room
This is a standard clinic exam room.  There is an exam table and two chairs. Standard medical examination equipment is available here.

Ms. Christian lies on the exam table shivering. She has a heavy down coat drawn up around her face. She seems uncomfortable, but is able to answer questions.

You can also see a boyfriend here.

9:01 am

>mildred, how are you
"Hmmf," says Mildred Christian.

>mildred, age
"I am 22 years old."

[Your score has just gone up by one point.]

>mildred, chief complaint
"I've just been so sick, mainly sick to my stomach.

[Your score has just gone up by one point.]

>mildred, chief complaint
"I've just been so sick, mainly sick to my stomach.

[Your score has just gone up by one point.]

* * *

>in
Exam room
This is a standard clinic exam room.  There is an exam table and two chairs. Standard medical examination equipment is available here.

Ms. Christian lies on the exam table shivering. She has a heavy down coat drawn up around her face. She seems uncomfortable, but is able to answer questions.

You can also see a boyfriend here.

9:01 am

>ask mildred about age
"I am 22 years old."

>mildred, how old are you
"I am 22 years old."

* * *

>ask mildred age
I didn't understand that sentence.

>age
That's not a verb I recognise.

>hello, mildred
You are already talking to Mildred Christian.

That's not a verb I recognise.

>mildred, hi
You are already talking to Mildred Christian.

>ask mildred about her age
"Hmmf," says Mildred Christian.

>mildred, what is your age
"Hmmf," says Mildred Christian.

>mildred
That's not a verb I recognise.

>mildred, give me your age
"Hmmf," says Mildred Christian.

* * *

>in
Exam room
This is a standard clinic exam room.  There is an exam table and two chairs. Standard medical examination equipment is available here.

Ms. Christian lies on the exam table shivering. She has a heavy down coat drawn up around her face. She seems uncomfortable, but is able to answer questions.

You can also see a boyfriend here.

9:01 am

>hi, boyfriend
(addressing Mildred Christian)
"Hello, Doctor."

That's not a verb I recognise.

>say hi toher
Whom do you want to say that to?

>say hi to her
You are already talking to Mildred Christian.

>mildred, hello
You are already talking to Mildred Christian.

>out
Clinic hallway
It's your usual Wednesday at the West Berkeley Health Center. The nurse tells you about the next patient to see. "Her name is Mildred Christian. Her boyfriend brought her here. He says she has the flu."

You can see a chart here.

>in
Exam room
This is a standard clinic exam room.  There is an exam table and two chairs. Standard examination equipment is available

Ms. Christian lies on the exam table shivering. She has a heavy down coat drawn up around her face. She seems uncomfortable, but is able to answer questions.

You can also see a boyfriend here.

>mildred, hello
"Hello, Doctor."

>boyfriend, hello
"Hey doc, I'm just the boyfriend."

>t sarah hello
This provokes no reaction.

>t sarah hi
This provokes no reaction.

* * *

>in
Exam room
This is a standard clinic exam room.  There is an exam table and two chairs. Standard medical examination equipment is available here.

Ms. Christian lies on the exam table shivering. She has a heavy down coat drawn up around her face. She seems uncomfortable, but is able to answer questions.

You can also see a boyfriend here.

9:01 am

>mildred, what's wrong
"Hmmf," says Mildred Christian.

>mildred, tell me what's wrong
"I've been throwing up all day. Whatever I eat goes right through me, and now I don't want to eat. My stomach hurts.

* * *

>in
Exam room
This is a standard clinic exam room.  There is an exam table and two chairs. Standard medical examination equipment is available here.

Ms. Christian lies on the exam table shivering. She has a heavy down coat drawn up around her face. She seems uncomfortable, but is able to answer questions.

You can also see a boyfriend here.

9:01 am

>tell me more
There is no reply.

>mildred, tell me more
"I've been throwing up all day. Whatever I eat goes right through me, and now I don't want to eat. My stomach hurts.

>mildred chief complaint
That's not a verb I recognise.

>mildred, chief complaint
"I've just been so sick, mainly sick to my stomach.

>mildred, tell me more
"I've been throwing up all day. Whatever I eat goes right through me, and now I don't want to eat. My stomach hurts.

>mildred, details
"Hmmf," says Mildred Christian.

>mildred, tell me details
"I've been throwing up all day. Whatever I eat goes right through me, and now I don't want to eat. My stomach hurts.

* * *

>in
Exam room
This is a standard clinic exam room.  There is an exam table and two chairs. Standard medical examination equipment is available here.

Ms. Christian lies on the exam table shivering. She has a heavy down coat drawn up around her face. She seems uncomfortable, but is able to answer questions.

You can also see a boyfriend here.

9:01 am

>mildred, what is your age
"I am 22 years old."

>mildred, tell me your age
"I am 22 years old."

>boyfriend, tell me your age
The boyfriend has better things to do.

* * *

>in
Exam room
This is a standard clinic exam room.  There is an exam table and two chairs. Standard medical examination equipment is available here.

Ms. Christian lies on the exam table shivering. She has a heavy down coat drawn up around her face. She seems uncomfortable, but is able to answer questions.

You can also see a boyfriend here.

9:01 am

>ask mildred for age
9:02 am

>ask mildred for her age
9:03 am

>ask mildred about her age
"I am 22 years old."

[Your score has just gone up by one point.]

9:04 am

* * *

>ask mildred for age
9:02 am

>ask mildred what is your age
I didn't understand that sentence.

>ask mildred her age
I didn't understand that sentence.

>ask mildred age
I didn't understand that sentence.

* * *

>in
Exam room
This is a standard clinic exam room.  There is an exam table and two chairs. Standard medical examination equipment is available here.

Ms. Christian lies on the exam table shivering. She has a heavy down coat drawn up around her face. She seems uncomfortable, but is able to answer questions.

You can also see a boyfriend here.

9:01 am

>hi mildred
I only understood you as far as wanting to hi.

>hi, mildred
(addressing Mildred Christian)
"Hello, Doctor."

That's not a verb I recognise.

>talk to mildred
Which do you mean, Mildred Christian or Mildred Christian's boyfriend?

>talk to mildred christian
Which do you mean, Mildred Christian or Mildred Christian's boyfriend?

* * *

>in
Exam room
This is a standard clinic exam room.  There is an exam table and two chairs. Standard medical examination equipment is available here.

Ms. Christian lies on the exam table shivering. She has a heavy down coat drawn up around her face. She seems uncomfortable, but is able to answer questions.

You can also see a boyfriend here.

9:01 am

>mildred, what in the heck xxx are you
"Hmmf," says Mildred Christian.

* * *

>in
Exam room
This is a standard clinic exam room.  There is an exam table and two chairs. Standard medical examination equipment is available here.

Ms. Christian lies on the exam table shivering. She has a heavy down coat drawn up around her face. She seems uncomfortable, but is able to answer questions.

You can also see a boyfriend here.

9:01 am

>mildred,  hi
"Hello, Doctor."

>mildred, what is your age
"22"

>mildred, can you give me your age
"22"

>what is your age
That's not a verb I recognise.

* * *

>in
Exam room
This is a standard clinic exam room.  There is an exam table and two chairs. Standard medical examination equipment is available here.

Ms. Christian lies on the exam table shivering. She has a heavy down coat drawn up around her face. She seems uncomfortable, but is able to answer questions.

You can also see a boyfriend here.

9:01 am

>hello boyfriend
I only understood you as far as wanting to hello.

>hello, boyfriend
(addressing Mildred Christian)
"Hello, Doctor."

That's not a verb I recognise.

>talk to boyfriend
Mildred Christian's boyfriend does not respond.

>say hello to boyfriend
Mildred Christian's boyfriend does not respond.

* * *

>in
Exam room
This is a standard clinic exam room.  There is an exam table and two chairs. Standard medical examination equipment is available here.

Ms. Christian lies on the exam table shivering. She has a heavy down coat drawn up around her face. She seems uncomfortable, but is able to answer questions.

You can also see a boyfriend here.

9:01 am

>hello, mildred
(addressing Mildred Christian)
"Hello, Doctor."

That's not a verb I recognise.

>hello
You are already talking to Mildred Christian.

>mildred hello
That's not a verb I recognise.

>hello mildred
I only understood you as far as wanting to hello.

>hello, mildred
You are already talking to Mildred Christian.

That's not a verb I recognise.

>mildred
That's not a verb I recognise.

>look at mildred
Which do you mean, Mildred Christian or Mildred Christian's boyfriend?

>look at boyfriend
You see nothing special about Mildred Christian's boyfriend.

>look
Exam room
This is a standard clinic exam room.  There is an exam table and two chairs. Standard examination equipment is available

Ms. Christian lies on the exam table shivering. She has a heavy down coat drawn up around her face. She seems uncomfortable, but is able to answer questions.

You can also see Mildred Christian's boyfriend here.

>hello, mildred
You are already talking to Mildred Christian.

That's not a verb I recognise.

>talk to mildred
Which do you mean, Mildred Christian or Mildred Christian's boyfriend?

* * *

>in
Exam room
This is a standard clinic exam room.  There is an exam table and two chairs. Standard medical examination equipment is available here.

Ms. Christian lies on the exam table shivering. She has a heavy down coat drawn up around her face. She seems uncomfortable, but is able to answer questions.

You can also see a boyfriend here.

9:01 am

>mildred, how old are you
"I am 22 years old."

>mildred, what is your chief complaint
"I've just been so sick, mainly sick to my stomach.