Mildred Christian
An Interactive Fiction by Judith A. Lubbers, M.D;  Inform version by Keith Flower.
Release 1 / Serial number 121027 / Inform 7 build 6G60 (I6/v6.32 lib 6/12N) SD

Clinic hallway
It's your usual Wednesday at the West Berkeley Health Center. You are standing in the hallway outside an exam room.

You can see a chart here.

9:00 am

>in
Exam room
This is a standard clinic exam room.  There is an exam table and two chairs. Standard medical examination equipment is available here.

Ms. Christian lies on the exam table shivering. She has a heavy down coat drawn up around her face. She seems uncomfortable, but is able to answer questions.

9:01 am

>take mildred's blood pressure
100/68
9:02 am

>take her blood pressure
100/68
9:03 am

* * *

>in
Exam room
This is a standard clinic exam room.  There is an exam table and two chairs. Standard medical examination equipment is available here.

Ms. Christian lies on the exam table shivering. She has a heavy down coat drawn up around her face. She seems uncomfortable, but is able to answer questions.

9:01 am

>look
Exam room
This is a standard clinic exam room.  There is an exam table and two chairs. Standard medical examination equipment is available here.

Ms. Christian lies on the exam table shivering. She has a heavy down coat drawn up around her face. She seems uncomfortable, but is able to answer questions.

9:02 am

>examine mildred
(Mildred Christian)
You see nothing special about Mildred Christian.

9:03 am

* * *

>in
Exam room
This is a standard clinic exam room.  There is an exam table and two chairs. Standard medical examination equipment is available here.

Ms. Christian lies on the exam table shivering. She has a heavy down coat drawn up around her face. She seems uncomfortable, but is able to answer questions.

9:01 am

>take her blood pressure
100/68
9:02 am

>her
That's not a verb I recognise.

9:01 am

>her, hello
"Hello, Doctor."

9:02 am

>her, age
I am 22 years old."

[Your score has just gone up by one point.]

9:03 am

>her, complaint
I've just been so sick, mainly sick to my stomach.

[Your score has just gone up by one point.]

9:04 am

>her, details
I've been throwing up all day. Whatever I eat goes right through me, and now I don't want to eat. My stomach hurts. 

Great, you got some initial information. Now get into greater detail
You enter the exam room.

[Your score has just gone up by one point.]

9:05 am

>her, pain
It's been crampy, and it comes and goes.

[Your score has just gone up by one point.]

9:06 am

>her, diarrhea
I haven't thrown up anything like coffee grounds, nor bright red blood.

Ok, enough info - let's do an exam on the patient.

[Your score has just gone up by one point.]

9:07 am

>auscultate her heart
[Sound effect number 5 here.]
9:08 am

* * *

>take her blood pressure
100/68
9:02 am

>take her
I don't suppose Mildred Christian would care for that.

9:02 am

>auscultate mildred christian heart
Don't you think you should get her history first?

9:03 am

>take mildred blood pressure
100/68
9:04 am

>take her blood pressure
I only understood you as far as wanting to take Mildred Christian.

9:04 am

* * *

>take her blood pressure
100/68
9:02 am

>take pt blood pressure
100/68
9:03 am

>take mildred's blood pressure
That seems to be a part of Mildred Christian.

9:04 am

>take mildred blood pressure
That seems to be a part of Mildred Christian.

9:05 am

* * *

>in
Exam room
This is a standard clinic exam room.  There is an exam table and two chairs. Standard medical examination equipment is available here.

Ms. Christian lies on the exam table shivering. She has a heavy down coat drawn up around her face. She seems uncomfortable, but is able to answer questions.

9:01 am

>mildred sit
I didn't understand that sentence.

9:01 am

>mildred, sit
(on Mildred Christian)
"What?" says Mildred Christian.

9:02 am

>mildred sit up
9:03 am

* * *

>in
Exam room
This is a standard clinic exam room.  There is an exam table and two chairs. Standard medical examination equipment is available here.

Ms. Christian lies on the exam table shivering. She has a heavy down coat drawn up around her face. She seems uncomfortable, but is able to answer questions.

9:01 am

>mildred, age
I am 22 years old."

[Your score has just gone up by one point.]

9:02 am

>mildred, why is she here
"Hmmf," says Mildred Christian.

9:03 am

>mildred, why she is here
I've just been so sick, mainly sick to my stomach.

[Your score has just gone up by one point.]

9:04 am

>mildred details
That's not a verb I recognise.

9:04 am

>mildred, details
I've been throwing up all day. Whatever I eat goes right through me, and now I don't want to eat. My stomach hurts. 

Great, you got the initial information
[Your score has just gone up by one point.]

9:05 am

>mildred, times vomited
"Hmmf," says Mildred Christian.

9:06 am

>mildred, diarrhea
I haven't thrown up anything like coffee grounds, nor bright red blood.

[Your score has just gone up by one point.]

9:07 am

>mildred, black
"Hmmf," says Mildred Christian.

9:08 am

>mildred, black stools
"Hmmf," says Mildred Christian.

9:09 am

>mildred, tarry
"Hmmf," says Mildred Christian.

9:10 am

>mildred, vomit
"Hmmf," says Mildred Christian.

9:11 am

>mildred, times vomited
"Hmmf," says Mildred Christian.

9:12 am

>mildred diarrhea
That's not a verb I recognise.

9:12 am

>mildred, diarrhea
I haven't thrown up anything like coffee grounds, nor bright red blood.

9:13 am

>mildred, diarrhea appearance
I haven't thrown up anything like coffee grounds, nor bright red blood.

9:14 am

* * *

>in
Exam room
This is a standard clinic exam room.  There is an exam table and two chairs. Standard medical examination equipment is available here.

Ms. Christian lies on the exam table shivering. She has a heavy down coat drawn up around her face. She seems uncomfortable, but is able to answer questions.

9:01 am

>mildred sit up
Mildred Christian sits up.

9:02 am

>take mildred pulse
142
9:03 am

>mildred stand up
Mildred Christian stands up.

9:04 am

>take mildred pulse
144
9:05 am

>mildred lay down
Mildred Christian lays down.

9:06 am

>take mildred pulse
130
9:07 am

>hint
That's not a verb I recognise.

9:07 am

* * *

>in
Exam room
This is a standard clinic exam room.  There is an exam table and two chairs. Standard medical examination equipment is available here.

Ms. Christian lies on the exam table shivering. She has a heavy down coat drawn up around her face. She seems uncomfortable, but is able to answer questions.

9:01 am

>mildred, sit down
"Hmmf," says Mildred Christian.

9:02 am

>mildred sit down
I didn't understand that sentence.

9:02 am

>mildren sit up
That's not a verb I recognise.

9:02 am

>mildred sit up
Mildred Christian sits up.

9:03 am

>take mildred pulse
142
9:04 am

>mildred lay down
Mildred Christian lays down.

9:05 am

>take mildred pulse
130142
9:06 am

>mildred stand up
I didn't understand that sentence.

9:06 am

* * *

>in
Exam room
This is a standard clinic exam room.  There is an exam table and two chairs. Standard medical examination equipment is available here.

Ms. Christian lies on the exam table shivering. She has a heavy down coat drawn up around her face. She seems uncomfortable, but is able to answer questions.

9:01 am

>get her blood pressure
100/68
9:02 am

>get blood pressure
You can't see any such thing.

9:02 am

* * *

>in
Exam room
This is a standard clinic exam room.  There is an exam table and two chairs. Standard medical examination equipment is available here.

Ms. Christian lies on the exam table shivering. She has a heavy down coat drawn up around her face. She seems uncomfortable, but is able to answer questions.

9:01 am

>mildred, sit up
"Hmmf," says Mildred Christian.

9:02 am

>mildred sit up
9:03 am

>take mildred pulse
130
9:04 am

* * *

>in
Exam room
This is a standard clinic exam room.  There is an exam table and two chairs. Standard medical examination equipment is available here.

Ms. Christian lies on the exam table shivering. She has a heavy down coat drawn up around her face. She seems uncomfortable, but is able to answer questions.

9:01 am

>mildred stand up
Mildred Christian stands up.

9:02 am

>take mildred pulse
144
9:03 am

>mildred lay down
Mildred Christian lays down.

9:04 am

>take mildred pulse
130142
9:05 am

>mildred sit up
Mildred Christian sits up.

9:06 am

>take mildred pulse
142
9:07 am

* * *

>in
Exam room
This is a standard clinic exam room.  There is an exam table and two chairs. Standard medical examination equipment is available here.

Ms. Christian lies on the exam table shivering. She has a heavy down coat drawn up around her face. She seems uncomfortable, but is able to answer questions.

9:01 am

>take mildred blood pressure
100/68
9:02 am

>take her blood pressure
I only understood you as far as wanting to take Mildred Christian.

9:02 am

* * *

>in
Exam room
This is a standard clinic exam room.  There is an exam table and two chairs. Standard medical examination equipment is available here.

Ms. Christian lies on the exam table shivering. She has a heavy down coat drawn up around her face. She seems uncomfortable, but is able to answer questions.

9:01 am

>take blood pressure
You must supply a noun.

9:02 am

>take her blood pressure
100/68
9:03 am

* * *

>in
Exam room
This is a standard clinic exam room.  There is an exam table and two chairs. Standard medical examination equipment is available here.

Ms. Christian lies on the exam table shivering. She has a heavy down coat drawn up around her face. She seems uncomfortable, but is able to answer questions.

9:01 am

>mildred lay down
9:02 am

>mildred sit up
Mildred Christian sits up.

Mildred Christian lays down.

Mildred Christian stands up.

9:03 am

* * *

>in
Exam room
This is a standard clinic exam room.  There is an exam table and two chairs. Standard medical examination equipment is available here.

Ms. Christian lies on the exam table shivering. She has a heavy down coat drawn up around her face. She seems uncomfortable, but is able to answer questions.

9:01 am

>take her pulse
9:02 am

* * *

Mildred Christian
An Interactive Fiction by Judith A. Lubbers, M.D;  Inform version by Keith Flower.
Release 1 / Serial number 121027 / Inform 7 build 6G60 (I6/v6.32 lib 6/12N) SD

Clinic hallway
It's your usual Wednesday at the West Berkeley Health Center. You are standing in the hallway outside an exam room.

You can see a chart here.

9:00 am

>read chart
You read: 
  Mildred Christian
  Age _____ 
  Pulse ______ 
  Blood pressure _______ 
  Temp________ 
  Nurses notes:  "Her boyfriend brought her here. He says she has the flu"

9:01 am

>in
Exam room
This is a standard clinic exam room.  There is an exam table and two chairs. Standard medical examination equipment is available here.

Ms. Christian lies on the exam table shivering. She has a heavy down coat drawn up around her face. She seems uncomfortable, but is able to answer questions.

9:02 am

>mildred, age
I am 22 years old."

[Your score has just gone up by one point.]

9:03 am

>mildred how old are you
I didn't understand that sentence.

9:03 am

>get mildred age
I didn't understand that sentence.

9:03 am

>mildred, how old are you
I am 22 years old."

9:04 am

>pt, details
I've been throwing up all day. Whatever I eat goes right through me, and now I don't want to eat. My stomach hurts. 

[Your score has just gone up by one point.]

9:05 am

>pt, complaint
I've just been so sick, mainly sick to my stomach.

Great, you got some initial information. Now get into greater detail
You enter the exam room.

[Your score has just gone up by one point.]

9:06 am

>pt, pain
It's been crampy, and it comes and goes.

[Your score has just gone up by one point.]

9:07 am

>pt, diarrhea
I haven't thrown up anything like coffee grounds, nor bright red blood.

Ok, enough info - let's do an exam on the patient.

[Your score has just gone up by one point.]

9:08 am

>examine pt eyes
I only understood you as far as wanting to examine Mildred Christian.

9:08 am

>examine pt's eyes
I only understood you as far as wanting to examine Mildred Christian.

9:08 am

>examine mildred's eyes
9:09 am

>examine pt eyes
I only understood you as far as wanting to examine Mildred Christian.

9:09 am